##########
##....#..#
#..###.#.#
##.#..##.#
#.......##
@.#..##..#
#.#####..#
..##...#.#
#....#...#
##########

