@.........
######..#.#
..........
.#########
..........
##....##.#
..........
.#########
..........#
#########.
#.........#